xxxxxxxxxxxxxxxxxxxxxxxxxxxxxxxx
xx.............m..............xx
x.....C........................x
x..............................x
x..........................C...x
x.......xxxxx......xxxxx.......x
x...C...x..............x.......x
x.......x...C..........x.......x
x.......x.........C....x.......x
x.......x..............x.......x
x..............................x
x..............xx......C.......x
x....U.........xx..............x
x..................U...........x
x.......x........p.....x.......x
x.......x.....C........x.......x
x.......x..............x.......x
x.......x..............x.......x
x.......xxxxx......xxxxx.......x
x..............................x
x.........................C....x
x.......C......................x
xx.............m..............xx
xxxxxxxxxxxxxxxxxxxxxxxxxxxxxxxx